#######
###  ##
##@$.##
# $$  #
# . . #
###   #
#######