######
# .###
#  ###
#*@  #
#  $ #
#  ###
######