#######
#     #
#@  $.#
#     #
#######