########
#      #
# .**$@#
#      #
#####  #
########