######
# #@ #
# $* #
# .* #
#    #
######