#######
##  ###
## $$ #
##... #
#  @$ #
#   ###
#######