#######
#  ####
# . . #
# $$#@#
##    #
#######