#######
#  *  #
#     #
## # ##
##$@.##
##   ##
#######