#######
#   ###
# @ ###
# $$###
##. . #
##    #
#######